1111111111111111111
1001000111C10000011
10C0000100010000011
101001010E010100C01
11C00C010CC00000011
11C00C0111110000001
11C00C0C0C0C0001001
1000010C0C0C0010001
10C00C010P010001011
10100C0C0C0C000C001
10C00C010C010000011
1111111111111111111