111111111111
1111CECCCCC1
1PCCCCCCCCC1
11C1CCC0CCC1
111111111111