11111111111111111111111111111111111111111111
1000000000000000000000000000000000000000E001
1C0C0C0C0000001C00000000001C1C10000000000001
101C00C110C0C11C01C0C1000000CC1C1C1C10000001
10101010000C00000000CCCCCCCCCCCCCC0000000001
101010000000C0001C1C1C1C1C1C1C1C100000000001
1000000P00000C000000CC0C0C0C0C0C000000000001
11111111111111111111111111111111111111111111