1111111111111111111111
10100010101010101011E1
110100000000000000C001
101C01000010101010P101
11010001C1010101010111
1111111111111111111111
